******--
*----*--
**-F-*--
-*-***--
-**-----
--*****S